NO ./assets/gravel.xpm
SO ./assets/redpattern.xpm
WE ./assets/hierba.xpm
EA ./assets/yelltexpattern.xpm


F 38,171,191
C 255,255,255


11111111111111111111111111
1000000000110000000000001
1011000001110000000000001
1001000000000000000000001
111111111011000001110000111111111
100000000011000001110111111111111
111101111111110111000000100011
1111011111111101 1101010100001
110000001101010111000000100011
10000000000000001100000010001
10000000000000011010100000111
110010011101010111110110N0111
11110111 1110101 101111010011111
11111111 1111111 111111111111